jpe=jp
jpo=jnp
jz=je
jnz=jne
jnl=jge
jnle=jg
jnge=jl
jng=jle
jnbe=ja
jnae=jb
jc=jb
jna=jbe
jnc=jnb
jae=jnb
mov eip,="jmp "

sal=shl

cmovpe=cmovp
cmovpo=cmovnp
cmovz=cmove
cmovnz=cmovne
cmovnl=cmovge
cmovnle=cmovg
cmovnge=cmovl
cmovng=cmovle
cmovnbe=cmova
cmovnae=cmovb
cmovc=cmovb
cmovna=cmovbe
cmovnc=cmovnb
cmovae=cmovnb

setpe=setp
setpo=setnp
setz=sete
setnz=setne
setnl=setge
setnle=setg
setnge=setl
setng=setle
setnbe=seta
setnae=setb
setc=setb
setna=setbe
setnc=setnb
setae=setnb
